0WWWWWWWWWWWWWWWWWWW0
0W11111111W11111111W0
0W2WW1WWW1W1WWW1WW2W0
0W11111111111111111W0
0W1WW1W1WWWWW1W1WW1W0
0W1111W111W111W1111W0
0WWWW1WWW1W1WWW1WWWW0
0000W1W000G000W1W0000
WWWWW1W0WWWWW0W1WWWWW
00000100W0S0W00100000
WWWWW1W0WWWWW0W1WWWWW
0000W1W000I000W1W0000
0WWWW1W0WWWWW0W1WWWW0
0W11111111W11111111W0
0W1WW1WWW1W1WWW1WW1W0
0W21W11111P11111W12W0
0WW1W1W1WWWWW1W1W1WW0
0W1111W111W111W1111W0
0W1WWWWWW1W1WWWWWW1W0
0W11111111111111111W0
0WWWWWWWWWWWWWWWWWWW0
